

           *

                                                             *G*
      *   ***                                               ****
                     *   *           *   *                 *****
                    **   **         **   **               ******
                   ***   ***       ***   ***             *******
                  ****   ****     ****   ****           ********
**************************************   ***********************
