

           *

                                                            *G*
      *   ***                                              ****
                     *  *           **  *                 *****
                    **  **         ***  **               ******
                   ***  ***       ****  ***             *******
                  ****  ****     *****  ****           ********
**************************************  ***********************
