



                                                                                                         *G*   
                                                                                                  *      ***
                                                                       *   *               *             ***
         * * *  * * *                        *  *  * *  *  *          **   **       *                 *
        **          **                      **             **        ***   ***                 *
       ***          ***        *  *        ***             ***      ****   ****         *
**********          *********        *********             *************   *******
