

                                       *   * **********  *   *  *   *  ***************  *****
                                       *              *
           **                          *              *
           **                          *              *
         ****          *               ********** *   *                  ***  ***************
         ****          *                              *
       ******          *                              *
       ******          *                              *
*************    *************   **********************                    ****************G*
